{
    "atm": {
        "1": 666,
        "2": 666,
        "3": 666,
        "4": 666,
        "5": 666,
        "6": 666,
        "7": 666,
        "8": 666
    },
    "cpl": {
        "1": 666,
        "2": 666,
        "3": 666,
        "4": 666,
        "5": 666,
        "6": 666,
        "7": 666,
        "8": 666
    },
    "ice": {
        "1": 666,
        "2": 666,
        "3": 666,
        "4": 666,
        "5": 666,
        "6": 666,
        "7": 666,
        "8": 666
    },
    "lnd": {
        "1": 666,
        "2": 666,
        "3": 666,
        "4": 666,
        "5": 666,
        "6": 666,
        "7": 666,
        "8": 666
    },
    "ocn": {
        "1": 666,
        "2": 666,
        "3": 666,
        "4": 666,
        "5": 666,
        "6": 666,
        "7": 666,
        "8": 666
    }
}